#####################
#X  #   #           #
# #   # # ####### # #
# #####   #     # ###
# #   #   # ### #   #
#   # # ###   ##### #
##### # #     #   # #
#   # # # ##### # # #
### # ### #     #   #
#   #     #### ######
# # # #####    #    #
# # # #   # #### ## #
# # ### # #       # #
# # #   # ######### #
# # #   #      #    #
# # # ########   ####
# # # #      #####  #
# ### ######        #
#                #  #
##################--#
